270 271 298 287 171 168 302 272 287 88 145 146 147 148 149 150 172 302 0 0 0 0 0 0 0 0 0 0 0 0 0 0 0 0 0 0 0 0 0 0 
284 285 289 302 272 300 265 286 263 237 159 160 161 162 163 164 165 144 0 0 0 0 0 0 0 0 0 0 0 0 0 0 0 0 0 0 0 0 0 0 
169 299 303 229 286 233 298 264 170 251 173 174 175 176 177 178 142 287 143 0 0 0 0 0 0 0 0 0 0 0 0 0 0 0 0 0 0 0 0 0 
230 302 301 168 0 302 0 284 302 0 187 188 189 190 191 192 109 141 0 143 0 0 0 0 0 0 0 0 0 0 0 0 0 0 0 0 0 0 0 0 
0 0 257 0 284 172 0 0 142 109 108 108 108 108 108 108 108 141 142 157 141 0 0 0 0 0 0 0 0 0 0 0 0 0 0 0 0 0 0 0 
0 0 0 0 0 0 0 170 109 108 108 108 199 200 201 202 108 109 154 143 0 0 0 0 0 0 0 0 0 0 0 0 0 0 0 0 0 0 0 0 
109 109 109 109 109 109 109 109 108 108 108 108 213 214 215 216 108 108 0 144 0 143 0 0 0 0 0 0 0 0 0 0 0 0 0 0 0 0 0 0 
108 108 108 108 108 108 108 108 108 108 108 108 108 108 108 108 108 108 109 144 0 154 171 0 0 0 0 0 0 0 0 0 0 0 0 0 0 0 0 0 
118 0 0 155 143 144 0 154 0 0 0 121 108 108 108 108 108 108 108 109 154 143 155 0 0 0 170 0 0 0 0 0 0 158 0 0 0 0 0 0 
0 156 141 170 272 157 0 169 168 141 143 0 121 108 108 108 108 108 108 108 109 109 144 0 171 140 141 140 0 156 0 0 170 156 0 156 0 170 144 0 
169 171 169 156 286 301 0 157 170 155 169 298 0 79 108 108 108 108 108 108 108 108 109 141 154 170 0 0 172 156 171 156 0 156 0 0 172 0 0 0 
270 271 301 170 169 156 158 6 154 8 9 10 287 79 108 108 108 108 108 108 108 108 108 109 109 109 109 109 210 211 212 109 109 109 109 109 109 109 109 109 
284 285 168 0 17 18 19 20 21 22 23 24 272 79 108 108 108 108 108 108 108 108 108 108 108 108 108 108 224 225 226 108 108 108 108 108 108 108 108 108 
298 299 43 44 31 32 33 34 35 36 37 38 286 79 108 108 108 108 108 108 108 108 108 108 108 108 108 108 238 239 240 108 108 108 199 200 201 202 108 108 
168 56 57 58 45 46 47 48 49 50 51 38 300 79 108 108 108 108 108 0 141 0 144 108 108 108 108 108 252 253 254 108 108 108 213 214 215 216 108 108 
172 70 71 72 59 60 61 62 63 64 65 52 53 79 108 108 108 108 157 154 0 140 0 0 0 143 108 108 266 267 268 108 108 108 108 108 108 108 108 108 
169 70 85 86 73 74 75 76 77 132 79 66 67 79 108 108 108 108 142 170 143 142 0 0 156 0 0 170 171 0 144 171 0 0 0 144 108 108 108 108 
170 70 99 100 79 104 131 79 91 92 79 80 81 79 108 108 108 108 0 142 0 143 158 0 142 0 170 158 273 274 170 0 170 0 141 0 0 0 0 0 
241 84 113 79 91 92 132 79 79 79 79 94 95 137 108 108 108 108 109 1 141 156 0 0 141 142 0 231 0 170 143 0 0 0 0 143 0 0 0 0 
255 98 79 79 79 79 90 79 79 79 91 92 137 136 108 108 108 108 108 158 154 0 172 155 170 0 0 172 258 0 0 0 0 0 0 0 0 0 0 0 
269 112 79 79 79 79 79 79 79 79 79 79 135 109 108 108 108 108 108 1 171 168 170 0 0 0 143 259 260 0 0 0 0 0 0 0 0 143 0 0 
283 126 107 79 79 79 79 79 79 79 79 79 186 145 146 147 148 149 150 154 0 171 140 155 0 172 169 273 274 0 0 0 0 0 0 0 0 0 0 0 
79 91 92 132 79 79 79 79 79 79 79 79 151 159 160 161 162 163 164 1 172 237 170 0 172 0 157 230 258 0 0 0 0 0 0 0 0 0 0 0 
79 79 79 79 79 79 79 79 79 132 79 115 133 173 174 175 176 177 178 0 141 251 233 234 235 236 233 242 243 172 0 0 0 0 0 0 0 141 0 0 
79 79 79 79 79 79 79 90 105 79 79 137 136 187 188 189 190 191 192 142 0 0 247 248 249 157 0 171 168 157 0 0 0 0 0 0 0 154 0 141 
79 79 79 107 79 79 79 104 79 137 134 136 109 108 108 108 108 108 108 109 0 172 261 262 0 0 168 272 171 158 0 0 0 0 0 0 0 144 155 0 
79 79 132 90 123 137 134 134 134 136 109 109 108 108 199 200 201 202 108 108 0 0 275 276 277 278 170 286 168 0 0 0 0 0 0 0 170 155 155 0 
134 134 134 134 134 136 109 109 109 109 108 108 108 108 213 214 215 216 108 108 141 172 156 290 291 292 298 169 0 0 0 0 0 0 0 0 0 154 0 141 
109 109 109 109 109 109 108 108 108 108 108 108 108 108 108 108 108 108 108 108 0 169 0 156 305 306 307 142 0 0 155 0 242 243 0 155 141 0 141 0 
108 108 108 108 108 108 108 108 108 108 108 108 108 108 108 108 108 108 108 142 157 142 0 0 172 142 156 287 157 0 172 170 0 288 0 264 237 287 141 0 
108 108 108 108 108 108 108 108 108 108 108 108 108 108 108 108 0 144 144 0 172 170 143 0 0 0 0 0 0 228 0 289 244 172 263 272 251 170 142 0 
108 108 108 108 108 108 108 108 108 108 108 108 108 108 108 108 0 0 0 140 143 169 0 0 0 0 0 234 235 236 232 0 158 301 170 286 301 169 0 170 
108 108 108 108 108 108 108 108 108 108 108 108 108 0 0 0 0 0 0 0 0 0 0 0 0 0 247 248 249 250 0 158 0 0 171 168 170 300 0 0 
108 108 108 108 108 108 108 108 108 108 108 0 0 0 0 0 0 0 0 0 0 0 0 0 0 155 261 262 272 284 0 287 288 289 0 0 140 141 0 0 
108 108 108 108 108 108 108 108 108 0 0 0 0 0 0 0 0 0 0 0 0 0 0 0 0 0 0 284 286 170 0 301 302 303 298 0 169 270 271 284 
108 108 108 108 108 108 108 0 0 0 0 0 0 0 0 0 0 0 0 0 0 0 0 0 0 0 142 258 168 141 0 169 298 273 274 301 170 170 285 0 
108 108 108 108 108 0 0 0 0 0 0 0 0 0 0 0 0 0 0 0 0 0 0 0 0 0 245 246 0 0 0 233 0 140 157 157 300 157 299 0 
108 108 108 108 0 0 0 0 0 0 0 0 171 0 170 0 0 171 144 0 0 0 0 0 0 288 230 142 170 0 155 272 155 0 0 0 172 0 301 302 
108 108 108 0 0 0 0 0 0 140 0 171 170 169 141 170 0 144 0 171 141 256 257 170 259 260 155 0 0 0 287 286 169 170 287 0 0 157 0 0 
108 108 108 0 0 0 0 0 0 0 0 0 0 0 0 0 144 0 0 0 0 0 0 0 0 0 0 0 0 0 0 0 0 0 0 0 0 0 0 0